r
$hh$shhcl

...\............
mc..\.c..c...c..
.....\..........
......--........
................
--------------..
................
................
................
................
................

.......\........
.c...c..\.cm...c
.........\......
..........\.....
...........\....
--..---------B..
................
..............--
................
............--..
................