r
lhh$hwhh

.....\..........
....c.\......c..
.......\........
----------------
................
.c..............
................
..*......c......
.........i....i.
XXXXXXXXXXXXXXXX
XXXXXXXXXXXXXXXX

................
.k......c....c..
................
----------\.....
...........\....
.c...c....---R--
............/...
.....k...../....
........../...i.
XXXXXXXXXXXXXXXX
XXXXXXXXXXXXXXXX